WWWWWWWWWWWWWWWWWWWWWW
W####################W
W####################W
W##WWWWWWWWW#########W
W################WWWWW
W####################W
W#######WWWWW########W
W#######WWWWW########W
W#######WWWWW########W
W#######WWWWW########W
W####################W
W####################W
W###WWDDDWWWWW#######W
W####################W
WWWWWWWWWWWWWWWWWWWWWW