WWWWWWWWWWWWWWWWWWWWWW
WVVVVVVVVVVVVVVVVVVVVW
WVVVVVVVVVVVVVVVVVVVVW
WVVWWWWWWWWWVVVVVVVVVW
WVVVVVVVVVVVVVVVVWWWWW
WVVVVVVVVVVVVVVVVVVVVW
WVVVVVVVWWWWWVVVVVVVVW
WVVVVVVVWWWWWVVVVVVVVW
WVVVVVVVWWWWWVVVVVVVVW
WVVVVVVVWWWWWVVVVVVVVW
WVVVVVVVVVVVVVVVVVVVVW
WVVVVVVVVVVVVVVVVVVVVW
WVVVDDDDDDDDDDVVVVVVVW
WVVVVVVVVVVVVVVVVVVVVW
WWWWWWWWWWWWWWWWWWWWWW